WWWWWWW
W     W
WPC  BW
W     W
WWWWWWW