  WWWWW
WWW   W
WBPC  W
WWW CBW
WBWWC W
W W B WW
WC CCCBW
W   B  W
WWWWWWWW